111111
1P0001
100C01
10C0E1
111111