11111111111111111111111111111
1CCCCCCCCCCCCCCCCCCCCCCCCCCC1
1C0P00000000000000000000000C1
1C0000CCCC0000C000C000C0000C1
1C0000C00000000000CC00C0000C1
1C0000CCCC0000C000C0C0C0000C1
1C0000C0000000C000C00CC0000C1
1C0000C0000000C000C000C0000R1
1C0000000000000000000000000C1
1CCCCCCCCCCCCCCCCCCCCCCCCCCC1
11111111111111111111111111111