111111111111111111111111111111
1CCCCCCCCCCCCCCCCCCCCCCCCCCCC1
1C0P00000000000000000000000CC1
1C0000CCCC0000C000CC000C0000C1
1C0000C00000000000C0C00C0000C1
1C0000CCCC0000C000C00C0C0000C1
1C0000C0000000C000C000CC0000C1
1C0000C0000000C000C0000C0000R1
1C00000000000000000000000000C1
1CCCCCCCCCCCCCCCCCCCCCCCCCCCC1
111111111111111111111111111111