11111111111111111111111111111
1P1CCC1CCC1CCC1CCC1CCC1CCC1E1
1C1C1C1C1C1C1C1C1C1C1C1C1C1C1
1C1C1C1C1C1C1C1C1C1C1C1C1C1C1
1C1C1C1C1C1C1C1C1C1C1C1C1C1C1
1C1C1C1C1C1C1C1C1C1C1C1C1C1C1
1C1C1C1C1C1C1C1C1C1C1C1C1C1C1
1C1C1C1C1C1C1C1C1C1C1C1C1C1C1
1C1C1C1C1C1C1C1C1C1C1C1C1C1C1
1C1C1C1C1C1C1C1C1C1C1C1C1C1C1
1CCC1CCC1CCC1CCC1CCC1CCC1CCC1
11111111111111111111111111111