1111111111111
10010000000R1
1000011111001
1P0011p000001
1111111111111