1111111111111111111111111111111111
1000000000000000000000000000000001
1000111111111111110000CC0000000001
100000000001000C001000C0C000000001
10000000000100C0001000CC0000000001
1E0000000001000C00010C111110000001
1010010100110000101011000000010101
1010010010101010001001000000010101
1P0100000C00C0000000000000000000C1
1100001000000000001111111111110001
100111C101111111000000000CC0000001
10101CCC1CC1CCC1C10000100C10000001
10CCCCCCC1CCC1CCCC11CC1CCC10000001
1111111111111111111111111111111111