1111111111
1CCCCCCCE1
1CCCCCCCC1
1CCCCCCCC1
1CPCCCCCC1
1111111111