111111111111111
1P0000000000001
100000011110001
10C000000000001
100000000011111
1000C00000000E1
100000000000001
111111111111111