111111111
1P0000001
101011101
100C00001
111011101
1000000E1
111111111