111111111111
1P0000000001
101111111101
1010000000C1
101011111101
10C0000000E1
111111111111