11111111111111
1P000000000001
10101111110101
10C010000010C1
10111101111101
100000000000E1
11111111111111