111111111111111111
1P0000000000000001
101111111111111101
10C0000000000000C1
111111101111111101
100000001000000001
101111101011111101
10C0000000000000E1
111111111111111111